****************
*              *
*    *         *
*  S * E       *
*    *         *
*              *
*              *
****************